{
  "name": "Wasteland Outpost",
  "width": 20,
  "height": 12,
  "tileSize": 48,
  "tiles": [
    [1, 1, 1, 1, 1, 1, 1, 1, 1, 1, 1, 1, 1, 1, 1, 1, 1, 1, 1, 1],
    [1, 0, 0, 0, 0, 0, 0, 1, 0, 0, 0, 0, 1, 0, 0, 0, 0, 0, 0, 1],
    [1, 0, 3, 2, 0, 0, 0, 1, 0, 0, 0, 0, 1, 0, 0, 0, 2, 3, 0, 1],
    [1, 0, 2, 0, 0, 0, 0, 0, 0, 0, 0, 0, 0, 0, 0, 0, 0, 2, 0, 1],
    [1, 0, 0, 0, 0, 1, 1, 0, 0, 0, 0, 0, 0, 1, 1, 0, 0, 0, 0, 1],
    [1, 0, 0, 0, 0, 1, 0, 0, 0, 4, 4, 0, 0, 0, 1, 0, 0, 0, 0, 1],
    [1, 0, 0, 0, 0, 1, 0, 0, 0, 4, 4, 0, 0, 0, 1, 0, 0, 0, 0, 1],
    [1, 0, 0, 0, 0, 1, 1, 0, 0, 0, 0, 0, 0, 1, 1, 0, 0, 0, 0, 1],
    [1, 0, 2, 0, 0, 0, 0, 0, 0, 0, 0, 0, 0, 0, 0, 0, 0, 2, 0, 1],
    [1, 0, 3, 2, 0, 0, 0, 1, 0, 0, 0, 0, 1, 0, 0, 0, 2, 3, 0, 1],
    [1, 0, 0, 0, 0, 0, 0, 1, 0, 0, 0, 0, 1, 0, 0, 0, 0, 0, 0, 1],
    [1, 1, 1, 1, 1, 1, 1, 1, 1, 1, 1, 1, 1, 1, 1, 1, 1, 1, 1, 1]
  ],
  "spawnPoints": [
    { "x": 2, "y": 2 },
    { "x": 17, "y": 9 },
    { "x": 2, "y": 9 },
    { "x": 17, "y": 2 }
  ],
  "pickupSpawns": [
    { "x": 9, "y": 5, "type": "gun_ammo" },
    { "x": 10, "y": 6, "type": "gun_ammo" },
    { "x": 3, "y": 5, "type": "grenade" },
    { "x": 16, "y": 6, "type": "grenade" }
  ]
}
